OLD_MAP = [
	["1","1","1","1","1","1","1","1","1","1","1","1","1","1","1","1","1","1","1","1","1","1","1","1","1","1","1","1","1"],
	["1"," "," "," "," "," "," "," "," "," "," "," "," "," "," "," "," "," "," "," "," "," "," "," "," "," "," "," ","1"],
	["1"," ","1","1","1","1"," ","1","1","1","1","1","1","1"," ","1","1","1","1","1","1","1"," ","1","1","1","1"," ","1"],
	["1","b","1","1","1","1"," ","1","1","1","1","1","1","1"," ","1","1","1","1","1","1","1"," ","1","1","1","1","b","1"],
	["1"," "," "," "," "," "," ","1","1"," "," "," "," "," "," "," "," "," "," "," ","1","1"," "," "," "," "," "," ","1"],
	["1","1","1"," ","1","1"," ","1","1"," ","1","1"," ","1","1","1"," ","1","1"," ","1","1"," ","1","1"," ","1","1","1"],
	["1","1","1"," ","1","1"," ","1","1"," ","1","1"," ","1","1","1"," ","1","1"," ","1","1"," ","1","1"," ","1","1","1"],
	["1"," "," "," ","1","1"," "," "," "," ","1","1"," "," "," "," "," ","1","1"," "," "," "," ","1","1"," "," "," ","1"],
	["1"," ","1","1","1","1","1","1","1"," ","1","1","1","1","1","1","1","1","1"," ","1","1","1","1","1","1","1"," ","1"],
	["1"," ","1","1","1","1","1","1","1"," ","1","1","1","1","1","1","1","1","1"," ","1","1","1","1","1","1","1"," ","1"],
	["1"," "," "," "," "," "," "," "," "," "," "," "," "," ","g"," "," "," "," "," "," "," "," "," "," "," "," "," ","1"],
	["1","1","1"," ","1","1","1","1","1"," ","1","1","1","1","n","1","1","1","1"," ","1","1","1","1","1"," ","1","1","1"],
	["1","1","1"," ","1","1","1","1","1"," ","1","1","1","1","n","1","1","1","1"," ","1","1","1","1","1"," ","1","1","1"],
	[" "," "," "," "," "," "," ","1","1"," ","1","1","g","n","g","n","g","1","1"," ","1","1"," "," "," "," "," "," "," "],
	["1","1","1"," ","1","1"," ","1","1"," ","1","1","1","1","1","1","1","1","1"," ","1","1"," ","1","1"," ","1","1","1"],
	["1","1","1"," ","1","1"," ","1","1"," ","1","1","1","1","1","1","1","1","1"," ","1","1"," ","1","1"," ","1","1","1"],
	["1"," "," "," ","1","1"," "," "," "," "," "," "," "," "," "," "," "," "," "," "," "," "," ","1","1"," "," "," ","1"],
	["1"," ","1","1","1","1","1","1","1"," ","1","1","1","1","1","1","1","1","1"," ","1","1","1","1","1","1","1"," ","1"],
	["1"," ","1","1","1","1","1","1","1"," ","1","1","1","1","1","1","1","1","1"," ","1","1","1","1","1","1","1"," ","1"],
	["1"," "," "," "," "," "," "," "," "," "," "," "," "," "," "," "," "," "," "," "," "," "," "," "," "," "," "," ","1"],
	["1","1","1","1","1"," ","1","1","1","1","1","1"," ","1","1","1"," ","1","1","1","1","1","1"," ","1","1","1","1","1"],
	["1","1","1","1","1"," ","1","1","1","1","1","1"," ","1","1","1"," ","1","1","1","1","1","1"," ","1","1","1","1","1"],
	["1"," "," "," "," "," ","1","1"," "," "," "," "," "," ","p"," "," "," "," "," "," ","1","1"," "," "," "," "," ","1"],
	["1","b","1","1"," ","1","1","1"," ","1","1"," ","1","1","1","1","1"," ","1","1"," ","1","1","1"," ","1","1","b","1"],
	["1"," ","1","1"," ","1","1","1"," ","1","1"," ","1","1","1","1","1"," ","1","1"," ","1","1","1"," ","1","1"," ","1"],
	["1"," ","1","1"," "," "," "," "," ","1","1"," "," "," "," "," "," "," ","1","1"," "," "," "," "," ","1","1"," ","1"],
	["1"," ","1","1","1","1"," ","1","1","1","1","1","1","1"," ","1","1","1","1","1","1","1"," ","1","1","1","1"," ","1"],
	["1"," ","1","1","1","1"," ","1","1","1","1","1","1","1"," ","1","1","1","1","1","1","1"," ","1","1","1","1"," ","1"],
	["1"," "," "," "," "," "," "," "," "," "," "," "," "," "," "," "," "," "," "," "," "," "," "," "," "," "," "," ","1"],
	["1","1","1","1","1","1","1","1","1","1","1","1","1","1","1","1","1","1","1","1","1","1","1","1","1","1","1","1","1"]
]